1111111111111
100P00E000W01
1111111111111